▲▲▲▲▲▲▲▲▲▲▲▲▲▲▲▲▲▲▲▲▲▲▲▲▲▲▲▲▲▲▲▲▲▲▲▲▲▲▲▲▲▲▲▲▲▲▲▲▲▲▲▲▲▲▲▲▲▲▲▲▲▲▲▲▲░░░░      ▲ : Mountains    ░ : Sea
▲▲▲▲▲▲▲▲▲▲▲▲▲▲▲▲~~~▲▲▲▲▲▲▲▲▲▲▲▲▲▲▲▲▲▲▲▲▲▲▲▲▲▲▲▲▲▲▲▲▲▲▲▲▲▲▲▲▲▲▲▲▲▲▲▲▲░      ↑ : Trees        ~ : River
▲▲▲▲▲▲▲▲▲▲▲▲▲▲▲▲▲~~~▲   ▲             ¤↑↑↑↑↑▲▲▲▲▲▲▲▲▲▲▲▲▲▲▲▲▲▲▲▲▲░░░░      | : Shoreline    ∩ : ?
▲▲▲▲▲▲▲▲▲▲▲▲      ~~ ▲▲    ▲▲▲▲▲ ↑↑↑↑    ↑↑↑↑↑↑↑↑▲▲▲▲▲▲▲▲▲▲▲▲▲▲▲▲▲▲░░      
▲▲▲▲▲▲▲▲           ~~↑↑↑▲▲▲▲▲▲▲▲▲▲↑↑↑↑↑     ↑↑↑↑↑↑↑▲▲▲▲▲▲▲▲▲▲▲▲ φ▲▲░░      𓀠 : Player
▲▲▲▲▲    ↑↑         ~~ ↑↑↑↑↑↑↑↑↑↑↑↑↑          ↑↑↑↑↑↑↑↑↑▲▲▲▲▲▲▲  ▲▲░░░
▲▲▲▲¤   ↑↑            ~~¤   ↑↑↑↑↑↑      ↑       ↑↑↑↑    ↑↑▲▲▲  ▲▲░░░░      φ : Mysterious places
▲▲▲▲▲▲↑↑↑             ~~~     ↑↑↑↑↑    ↑↑      ↑↑↑↑  ↑↑       ▲▲▲▲░░░      √ : Mysteries solved
▲▲▲▲                   ~~         ▲▲▲ ▲▲▲        ↑↑↑  ↑↑↑↑↑▲▲▲▲▲▲░░░░      ¤ : Items stashes
▲▲▲                     ~~       ▲▲▲▲  ▲▲▲        ↑↑↑   ↑↑▲▲▲▲▲▲▲▲░░░
▲▲▲                     ~~         ▲▲ ¤▲▲           ↑↑↑    ▲▲▲▲▲▲░░░░
▲▲▲                     ~~~         ▲▲▲▲              ↑↑↑↑ ↑↑▲▲▲▲▲░░░
▲▲▲▲                     ~~~         ▲▲                ↑↑↑   ↑▲▲▲░░░░
▲▲▲▲▲                 ↑↑↑↑↑~~~~~                         ↑    ¤▲░░░░░
▲▲▲▲▲▲             ↑↑↑↑↑¤ ↑↑↑~~~~~~                            ▲░░░░░
▲▲▲▲▲↑↑↑↑↑       ↑↑↑↑                                          |░░░░░
▲▲▲▲¤    ↑↑             ↑↑↑↑↑↑↑↑↑~~~↑↑↑            ¤          |░░░░░░
▲▲▲↑↑↑↑   ↑↑              ↑↑↑↑↑↑↑~~~↑↑                        |░░░░░░
░▲▲  ↑↑↑↑                  ↑↑↑↑↑~~~↑↑                        |░░░░░░░
░▲▲↑↑↑        ↑              ↑↑~~↑↑↑                        |░░░░░░░░
░░|↑↑   ↑↑  ↑↑              ↑↑~~↑↑↑         ↑↑↑↑            |░░░░░░░░
░░░|  ↑↑↑  ↑↑↑            ↑↑↑~~↑↑↑↑       ↑↑↑↑              |░░░░░░░░
░░░░| ↑↑  ↑↑↑           ↑↑↑~~~       ↑↑  ↑↑↑↑              |░░░░░░░░░
░░░|↑ ↑↑ ↑↑↑↑            ↑~~~     ↑↑↑↑↑↑ ↑↑↑↑↑              |░░░░░░░░
░░|↑  ↑↑φ↑↑↑↑↑           ↑↑~~   ↑↑↑↑↑↑↑↑↑↑↑↑↑   ↑↑           |░░░░░░░
░░|↑ ↑↑↑↑↑↑↑↑            ↑↑~~↑↑↑↑↑↑ ↑↑↑ ↑↑↑↑  ↑↑↑↑          |░░░░░░░░
░░|↑     ↑↑↑↑  _______  ↑↑~~~ ↑ ↑↑↑↑↑↑↑↑↑↑↑  ↑↑↑___       𓀠|░░░░░░░░░
░░░|↑↑↑ ↑↑ ___|░░░░░░░|___~~¤_______  ↑↑↑ φ ↑↑↑|░░░|      |░░░░░░░░░░
░░░░|↑↑¤↑↑|░░░░░░░░░░░░░░░░░░░░░░░░░|________|░░░░░░|____|░░░░░░░░░░░
░░░░░░░░░░░░░░░░░░░░░░░░░░░░░░░░░░░░░░░░░░░░░░░░░░░░░░░░░░░░░░░░░░░░░
░░░░░░░░░░░░░░░░░░░░░░░░░░░░░░░░░░░░░░░░░░░░░░░░░░░░░░░░░░░░░░░░░░░░░
